111111111111111111
1P00000CE000010001
111111111111111111