1111111111
1P00000001
1111111101
1000000101
1011110101
101EC10101
1010000101
1011111101
1000000001
1111111111